1111111111
2222222222
3333333333
4444444444
5555535555